################
#--------------#
#--------------#
#-----------W--#
#--------------#
#--------------#
#--------------#
@-----------M--#
@--------------#
#--------------#
#--------------#
#--------------#
#-----------B--#
#--------------#
#--------------#
################