#######@@#######
#--------------#
#----#---#-----#
#--------------#
#--------------#
#--------------#
#--------------#
#----+---------#
#--------------#
#--------------#
#--------------#
#--------------#
#--------------#
#--------------#
#--------------#
################