#######@@#######
#--------------#
#----#---#-----#
#--------------#
#--------------#
#--------------#
#--------------#
#----+---------@
#--------------@
#--------------#
#--------------#
#--------------#
#--------------#
#--------------#
#--------------#
################