#######@@#######
#--------------#
#--------------#
#--------------#
#--------------#
#--------------#
#--------------#
@--------------#
@--------------#
#--------------#
#--------------#
#--------------#
#--------------#
#--------------#
#--------------#
################