#######@@#######
#--------------#
#----#---#-----#
#-----------W--#
#--------------#
#--------------#
#--------------#
@----+---------#
@--------------#
#--------------#
#--------------#
#--------------#
#---B----------#
#--------------#
#--------------#
################