MAP 1
################
#--------------#
#--------------#
#--------------#
#--------------#
#--------------#
#--------------#
@--------------#
@--------------#
#--------------#
#--------------#
#--------------#
#--------------#
#--------------#
#--------------#
################
MAP 2
################
#--------------#
#--#-----------#
#--------------#
#--------------#
#--------------#
#--------------#
@--------------#
@--------------#
#--------------#
#--------------#
#--------------#
#--------------#
#--------------#
#--------------#
################
MAP 3
################
#--------------#
#---##---------#
#--------------#
#--------------#
#--------------#
#--------------#
@--------------#
@--------------#
#--------------#
#--------------#
#--------------#
#--------------#
#--------------#
#--------------#
################
MAP 4
################
#--------------#
#--------------#
#-###----------#
#--------------#
#--------------#
#--------------#
@--------------#
@--------------#
#--------------#
#--------------#
#--------------#
#--------------#
#--------------#
#--------------#
################