################
#--------------#
#--------------#
#--------------#
#--------------#
#--------------#
#--------------#
@--------------@
@--------------@
#--------------#
#--------------#
#--------------#
#--------------#
#--------------#
#--------------#
################