#######@@#######
#--------------#
#--------------#
#--------------#
#--------------#
#--------------#
#--------------#
#--------------@
#--------------@
#--------------#
#--------------#
#--------------#
#--------------#
#--------------#
#--------------#
#######@@#######