######@@@######
#-------------#
#----#---#----#
#-------------#
#-------------#
#-------------#
@-------------@
@----+--------@
@-------------@
#-------------#
#-------------#
#-------------#
#-------------#
#-------------#
######@@@######