################
#--------------#
#----#---#-----#
#--------------#
#---B----------#
#--------------#
#--------------#
@----+---------@
@--------------@
#--------------#
#--------------#
#--------------#
#--------------#
#--------------#
#--------------#
################