#######@@#######
#--------------#
#--------------#
#--------------#
#--------------#
#--------------#
#--------------#
@--------------@
@--------------@
#--------------#
#--------------#
#--------------#
#--------------#
#--------------#
#--------------#
#######@@#######