####--#########
#-------------#
#-------------#
#---##--------#
---------------
---------------
#-------------#
#-------------#
#-------------#
#-------------#
#-------------#
#-------------#
#-------------#
#-------------#
####-------####