#######@@#######
#--------------#
#----#---#-----#
#--------------#
#--------------#
#--------------#
#--------------#
@----+---------@
@--------------@
#--------------#
#--------------#
#--------------#
#--------------#
#--------------#
#--------------#
#######@@#######