################
#--------------#
#--------------#
#--------------#
#--------------#
#--------------#
#--------------#
@-------T------#
@--------------#
#--------------#
#--------------#
#--------------#
#--------------#
#--------------#
#--------------#
################