################
#--------------#
#--------------#
#-----------+--#
#-----------+--#
#-----------+--#
#-----------+--#
@--------------#
@--------------#
#-----------+--#
#-----------+--#
#-----------+--#
#-----------+--#
#--------------#
#--------------#
################